1111111111111111111111111
1000C0000C0000000000000C1
1C0000P00000000010000CCE1
10000011111111111CCC11111
100000CC00C0C0C0C0C00C0C1
10000011000CCCCC00C0C0C01
10000000000000000CCCC0001
1111111111111111111111111